00111100000000010000000001010000
00110100001100000000000000010000
10001110000100000000000000000000
00111100000000010000000001010000
00110100001100110000000000000000
00100000000000100000000000001001
00100000000001000000000000010000
00000000000000000000000000001100
00000000000000101000100000100001
00000000000000100010000000100001
00000000000100110010100000100001
00000000000100000011000000100001
00001100000100000000000000100010
00000000000100010010000000100001
00100000000000100000000000000100
00000000000000000000000000001100
00100000000000100000000000001010
00000000000000000000000000001100
00100000110011111111111111111100
00011001111000000000000000000110
10001100101010000000000000000000
10101100100010000000000000000000
00100000110001101111111111111100
00100100101001010000000000000100
00100100100001000000000000000100
00001000000100000000000000010010
00010000110000000000000000000110
10010000101010000000000000000000
10100000100010000000000000000000
00100000110001101111111111111111
00100100101001010000000000000001
00100100100001000000000000000001
00001000000100000000000000011010
00000011111000000000000000001000
00100000110011111111111111111100
00011001111000001111111111110110
00000000100001011100000000100110
00110001000110000000000000000011
00000000000001000100100000100011
00110001001010010000000000000011
00010001001000000000000000000111
10010000101010000000000000000000
10100000100010000000000000000000
00100000110001101111111111111111
00100001001010011111111111111111
00100100101001010000000000000001
00100100100001000000000000000001
00001000000100000000000000101000
00010011000000001111111111100001
00100000110011111111111111111100
00011001111000001111111111100111
10001000101010000000000000000000
10011000101010000000000000000001
10101100100010000000000000000000
00100000110001101111111111111100
00100100101001010000000000000100
00100100100001000000000000000100
00001000000100000000000000110001
